001100000000000000000000000001100000000000000000000000001100000000000000000000000
011110000000000000000000000011110000000000000000000000011110000000000000000000000
111111000000000000000000000111111000000000000000000000111111000000000000000000000
111111000000000000000000000111111000000000000000000000111111000000000000000000000
011111111111111111111111110011111111111111111111111110011111111111111111111111110
001111111111111111111111111001111111111111111111111111001111111111111111111111111
011111111111111111111111110011111111111111111111111110011111111111111111111111110
111111000000000000000000000111111000000000000000000000111111000000000000000000000
111111000000000000000000000111111000000000000000000000111111000000000000000000000
011110000000000000000000000011110000000000000000000000011110000000000000000000000
001100000000000000000000000001100000000000000000000000001100000000000000000000000