11110000000000000000
01111000000000000000
11110000000000000000
00000111100000000000
00000011110000000000
00000111100000000000
00000000001111000000
00000000000111100000
00000000001111000000
00000000000000011110
00000000000000001111
00000000000000011110