1111111100000000000000000000000011111111
1111111100000000000000000000000011111111
0000000011111111000000001111111100000000
0000000011111111000000001111111100000000
0000000000000000111111110000000000000000
0000000000000000111111110000000000000000