0001110000000000000011100000000000
0011111000011100000111110000111000
0111111100111110001111111001111100
0111111101111111001111111011111110
0111111101111111001111111011111110
0011111001111111000111110011111110
0001110000111111000011100001111110
0000000000001110000000000000011100